UUUUUUUUUUUUUUU
DDDDDDDDDDDDDDD
DHDDDDDBDDDHHHN
DHBDDDDDDDDHDBD
DHDDDDDDDDBHDDD
DHDDDDDDGGDHDDD
DHEHDDDDDDDHDDD
DDDHDDDBDDBHDDD
DDDHDDDDDDDHDDD
DDDHEEHDDDDHDDD
DDDDDDHEEEEHDDD
................