UUUUUUUUUUUUUUU
DDDDDDDDDDDDDDD
HHHHHBDBDBHHHNH
GGDDHDGDGDHDDDD
GDDDHDGDGDHDBBD
DBBDHDGDGDHDGGD
GGGGHEEHEEHGGGG
GGGGDGDHDGDGGGG
DGGDDGDHDGDDGGD
GDDDDGDHDGDDDDG
GGDDDGDHDGDDDGG
................