UUUUUUUUUUUUUUU
DDDDDDDDDDDDDHD
DDDDDDDBDHEEEHD
DDBDDDDDHHDDDDD
DDDDDDDDHDBDDDB
DDDBDDEEHDDDDDD
DDDDDDDDDDDDDDD
DDDDDGDDDDDDDDD
DDDDDGGDDDDDDDD
DDDDDDDDDDDDDDD
DDDDDDDDDDDDDDD
................