UUUUUUUUUUUUUUU
DDDDDDDDDDDDDDD
DHDDGGDBDGDHHHH
DHBDGGDDDGDHDBD
DHDDGGDDDGBHGGG
DHDDGGDDDGDHGGG
DHEHDDDDDDDHGGG
DDDHDDDBDDBHDDD
DDDHDDDDDDDHDDD
DGDHEEHDDDDHDDG
DGGDDDHEEEEHDGG
................