DDDDDDDDDDDDDDDDDDDD
DDDDDDDDDDDDDDDDDDDD
DDDDDDDBDDDDDDDDDBDD
DDBDDDDDDDDDDDDDDDDD
DDDDDDDDDDBDDDBDDDDD
DDDDDDDDDDDDDDDDDDDD
DDDDDDDDDDDDDDDDDDDD
DDDDDDDDDDDDDDDDDDDD
DDDDDDDDDDDDDDDDDDDD
DDDDDDDDDBDDDDDBDDDD
DDDDDDDDDDDDDDDDDDDD
DDGDDDDDDDDDDDDDDDDD
DDGGDDDDDDDDDDDDDDDD
....................