UUUUUUUUUUUUUUU
DDDDDDDDDDDDDDD
DHEEHDBDDDBDHNH
DDDDHDDDDDDDHDD
DGGGHDGGGGGDHDD
DBGBHDGGGGGDHDB
DGGGHDDBDDDDHDD
DBDBHDGDDHEEHDD
DDDDHDGDDHDDDDD
DGDDHGGGDHDGGDD
DGGDHEEEEHDGGDD
................